abere	a-be-re	
igande	i-gan-de	
kide	ki-de	
ardatz	ar-datz	
zeharo	ze-ha-ro	
aditz	a-ditz	
orduko	or-du-ko	
froga	fro-ga	
masa	ma-sa	
estilo	es-ti-lo	
mina	mi-na	
beteko	be-te-ko	
arrunt	a-rrunt	
erdi	er-di	
kanta	kan-ta	
anaia	a-na-ia	
argi	ar-gi	
zulo	zu-lo	
baldin	bal-din	
kontu	kon-tu	
premia	pre-mi-a	
neurri	neu-rri	
luze	lu-ze	
nolako	no-la-ko	
musika	mu-si-ka	
beldur	bel-dur	
ogasun	o-ga-sun	
ezetz	e-zetz	
areago	a-re-a-go	
erre	e-rre	
plaza	pla-za	
eratu	e-ra-tu	
leku	le-ku	
preso	pre-so	
esate	e-sa-te	
arreta	a-rre-ta	
txiki	txi-ki	
beltz	beltz	
karga	kar-ga	
minutu	mi-nu-tu	
hortz	hortz	
ukan	u-kan	
gertu	ger-tu	
doan	do-an	
ederki	e-der-ki	
disko	dis-ko	
etxeko	e-txe-ko	
nobela	no-be-la	
bertso	ber-tso	
pena	pe-na	
aste	as-te	
pisu	pi-su	
asmatu	as-ma-tu	
aldera	al-de-ra	
jabe	ja-be	
iraun	i-raun	
egia	e-gi-a	
onik	o-nik	
iturri	i-tu-rri	
ezagun	e-za-gun	
jaten	ja-ten	
ontzi	on-tzi	
gela	ge-la	
prest	prest	
edan	e-dan	
baietz	ba-ietz	
adar	a-dar	
txori	txo-ri	
ildo	il-do	
arropa	a-rro-pa	
medio	me-di-o	
ireki	i-re-ki	
paper	pa-per	
parean	pa-re-an	
seme	se-me	
batean	ba-te-an	
buruan	bu-ru-an	
zentzu	zen-tzu	
abiatu	a-bi-a-tu	
gidari	gi-da-ri	
